NO textures/simonkraft/wet_sponge.png
SO textures/simonkraft/wet_sponge.png
WE textures/simonkraft/wet_sponge.png
EA textures/simonkraft/wet_sponge.png
F 220,100,0
C 225,30,0

111111111
100000001
100N00001
100000000
111111111
