F 164,169,2
NO textures/simonkraft/wet_sponge.png   
SO textures/simonkraft/wet_sponge.png                  
WE textures/simonkraft/wet_sponge.png   
EA textures/simonkraft/wet_sponge.png
C 153,+204,+255


1111111111111111111111
1010000000000000000001
10101010101111111000001
1010101000100000100011
1111101011011010111000
100000101000001N00001
101111101001101111111
101000001010100000101
101011111010111110101
101010001010100010101
101110101010101010101
100000101010001010001
111111101011111011101
100000101000100010001
101110101110101110111
101000100000100010101
101011111111111010101
100010000000000010001
101010111011111111101
101000001000000000001
111111111111111111111


